7 10
0 1 1 1 1 1 1 1 1 0
1 1 3 3 1 2 2 2 1 0
1 2 3 3 1 2 4 2 1 1
1 2 8 2 4 2 2 4 2 1
1 1 4 1 1 1 2 2 2 1
0 1 2 2 2 2 2 1 1 1
0 1 1 1 1 1 1 1 0 0
5 10