8 11
0 0 0 1 1 1 1 1 1 0 0
0 0 0 1 3 3 7 3 1 0 0
0 0 0 1 3 4 2 2 1 0 0
0 0 0 1 1 2 4 2 1 0 0
0 0 0 1 1 4 2 1 1 0 0
0 0 0 1 8 4 2 1 0 0 0
0 0 0 1 1 2 2 1 0 0 0
0 0 0 0 1 1 1 1 0 0 0
5 10