9 9
1 1 1 1 1 1 1 1 1
1 2 2 2 2 2 2 2 1
1 2 2 2 2 2 2 2 1
1 2 4 2 3 3 2 2 1
1 2 4 2 3 3 2 2 1
1 2 2 2 2 2 2 2 1
1 2 2 2 2 2 2 2 1
1 8 2 2 2 2 2 2 1
1 1 1 1 1 1 1 1 1
5 10