8 12
0 0 1 1 1 1 1 1 1 1 0 0
0 0 1 3 2 2 2 4 2 1 0 0
0 0 1 3 4 2 2 1 2 1 0 0
0 0 1 3 1 2 1 2 2 1 0 0
0 0 1 1 1 2 1 2 1 1 0 0
0 0 0 1 2 4 2 2 1 0 0 0
0 0 0 1 8 2 1 1 1 0 0 0
0 0 0 1 1 1 1 1 0 0 0 0
5 10